EA ./textures/bookshelf.xpm

R 900    900
NO ./textures/Dirt.xpm
SO ./textures/Bricks.xpm
WE ./textures/Bark.xpm



S ./textures/barrel.xpm

F       36,33,21

C   250,209,167



        1111111111111111111111111
        1000000000110000000000001
        1011000001110000002000001
        1001000000000000020200001
111111111011000001110000000000001
100000000011000001110111110111111
11110111111111011100000010001
11110111111111011101010010001
11000000110101011100000010001
10002000000000001100000000201
10000000000000001101010010201
1100000111010101111101111000111
11110111 1110101 101111010N01
11111111 1111111 111111111111